000000000000000000000000000000000000000000000000000000000000000000000000001000000000000000000000001000000000000000000000001000
000000000000000000000000000000000000000000000000000000000000000000000000001000000000000000000000001000000000000000000000001000
000000000000000000000000000000000000000000000000000000000000000000000000001000000000000000000000001000000000000000000000001000
000000000000000000000000000000000000000000000000000000000000000000000000001000000000000000000000001000000000000000000000001000
000000000000000000000000000000000000000000000000000000000000000000000000001000000000000000000000001000000000000000000000001000
000000000000000000000000000000000000000000000000000000000000000000000000001000000000000000000000001000000000000000000000001000
000000000000000000000000000000000000000000000000000000000000000000000000001000000000000000000000001000000000000000000000001000
000000000000000000000000000000000000000000000000000000000000000000000000001000000000000000000000001000000000000000000000001000
000000000000000000000000000000000000000000000000000000000000000000000000001000000000000000000000001000000000000000000000001000
000000000000000000000000000000000000000000000000000000000000000000000000001000000000000000000000001000000000000000000000001000
000000000000000000000000000000000000000000000000000000000000000000000000001000000000000000000000001000000000000000000000001000
000000000000000000000000000000000000000000000000000000000000000000000000001000000000000000000000001000000000000000000000001000
000000000000000000000000000000000000000000000000000000000000000000000000001000000000000000000000001000000000000000000000001000
000000000000000000000000000000000000000000000000000000000000000000000000001000000000000000000000001000000000000000000000001000
000000000000000000000000000000000000000000000000000000000000000000000000001000000000000000000000001000000000000000000000001000
000000000000000000000000000000000000000000000000000000000000000000000000001000000000000000000000001000000000000000000000001000
000000000222222200000000000000000000000000000000000000000000000000000000001000000000000000000000001000000000000000000000001000
000000000000000000000000000000000000000000000000000000000000000000000000021000000000000000000000001000000000000000000000001000
000000000000000000000000000000000000000000000000000000000000000000000000000000000000000000000000001002222222222222222212222000
200000004540000000200000000000000000000000000000000000003000000000000000003000000000000000002222221220000000000000000001000000
122222222222222222100000222200000222222222200000020000222200000020000222222222000000000000211000100000000000000000000001000000
111111111111111111100000011000000100000011000000010000011000000010000011111001222222222211100000100000000000000000000001000000
111111111111111111100000011000000000000011000000000000011000000000000011110000000000000000000000100000000000000000000001000000
111111111111111111100000011000000000000011000000000000011000000000000011100000000000000000000000100000000000000000000001000000
111111111111111111100000011000000000000011000000000000011000000000000011100000000000000000000000100000000000000000000001000000
111111111111111111100000011000000000000011000000000000011000000000000011000000000000000000000000100000000000000000000001000000
111111111111111111100040011000000040000011000400000000011000000000000010000000000000000000000000100000000000000000000001000000
000000000000000000022222222222222222222222222222222222220222222222222222222222222222200000000000100000000000000000000001000000
000000000000000000000000000000000000000000011111111111110111111111111111111111111111122222222222222222222222222222222222000000
000000000000000000000000000000000000000000000000000000010100000000000000000000000000000000000000000000000000000000000000000000
000000000000000000000000000000000000000000000000000000010100000000000000000000000000000000000000000000000000000000000000000000
000000000000000000000000000000000000000000000000000000012100000000000000000000000000000000000000000000000000000000000000000000